20001010111011100000001
01100010000000000000001
00101100110101000000001
01000001110101000000001
00111101101000100000001
10001100101110000000001
10101111000001100000001
10101000011101000000001
00011011010001000000001
10110000010111000000001
10001111010000100000001
11101000011100000000001
10001011111100100000001
10111010000000000000001
10000011101111311111011
10011111111111111111001
10111111110111111111101
10100000000000000000101
10000000000000000000001
11111111111111111111111