+------------------+
|      |           |
|--- + |    -----+ |
|    |           | |
| +  +------+    | |
| |         |    | |
| +---+     +----+ |
|     |            |
|--+  +------------|
|     |            |
|--+  |     +      |
|  |  |     | +----|
|  |        |      |
|  +------+---+    |
|             |    |
|    +----+   +    |
|    |             |
| +--|   +---------|
|    |            O|
+------------------+