# ^^^^^^^^^^^^^^^^^^^^^
^ ^    ^ ^^ ^  ##^^^^^^
^ ^^ ^   ^   ²^^#####^^
^   ^^^^   ^^^^^^^^^#^^
^  ^     ^^^  ^^^^^^#^^
^^ ^^^^ ^^   ^^^^^^##^^
^  ^^^    ^^^^^^^^^#^^^
^^   ^^ ^ ^^  ^^^^^#^^^
^^^ ^   ^   ^^^^^^^#^^^
^^^  ^^^^ ^^^^^^^^^##^^
^^^ ^^ ^  ^^  ^^^^^^#^^
^   ^  ^ ^^  ^^^^^^^#^^
^ ^^  ^     ^   ##^^#^^
^ ^^^ ^^ ^^ ^ ^^^##^#^^
^     ^^      #^^^###^^
^##^^^^^^^#^^^^^^^^^##^
^#^^^^^^^^#^^^^^^^^^^#^
^#^#################^#^
^#####################^
^^^^^^^^^^^^^^^^^^^^^^^