#                    ²^
^^^^^^^^^^^^^^^^^^^^^^^
^^^^^^^^^^^^^^^°^^^^^^^
^^^^^^^^^^^^^^^ ^^^^^^^
^^^^^^^^^^^^^^^ ^^^^^^^
^^^^^^^^^^^^^^^ ^^^^^^^
^^^^^^^^^^^^^^^ ^^^^^^^
^^^^^^^^^^^^^^^°^^^^^^^
^^^^^^^^^^^^^^^^^^^^^^^
^^^^^^^^^^^^^^^^^^^^^^^
^^^^^^^^^^^^^^^^^^^^^^^
^^^^^^^^^^^^^^^^^^^^^^^
^^^^^^^^^^^^^^^^^^^^^^^
^^^^^^^^^^^^^^^^^^^^^^^
^^^^^^^^^^^^^^^^^^^^^^^
^^^^^^^^^^^^^^^^^^^^^^^
^^^^^^^^^^^^^^^^^^^^^^^
^^^^^^^^^^^^^^^^^^^^^^^
^^^^^^^^^^^^^^^^^^^^^^^
^^^^^^^^^^^^^^^^^^^^^^^