#| | |^|^|^|^|^|^|^|^|^|^|^|^|^|^|^|^|^| | |10|^|
^|^| |^|^|^| |^|^|^|^|^|^|^|^|^|^| | | | |^|^|
^|^| | | | | |^|^|^| |^|^| |^|^|^| |^| |^|^|^|
^|^| | |^|^| | |^|^|^|^|^| |^|^|^| |^|^| |^|^|
^|^|^| |^|^|^| |^| |^|^|^| | | | | | | | |^|^|
^|^|^|^|^| | | |^|^| |^|^| |^|^|^|^|^| |^|^|^|
^| | |^|^| |^|^|^|^|^|^|^| |^| |^|^| | |^|^|^|
^| | | | | |^|^|^|^| | | | | | |^| | | | |^|^|
^| |^| |^| | | |^|^|^|^|^|^|^|^|^|^|^| | |^|^|
^| | | |^|^|^| | | |^|^|^|^| |^| |^| | | | |^|
^| |^|^|^| |^| |^| | | | |^| | | |^|^|^| |^|^|
^| | |^|^|^| | |^|^|^| |^|^|^| |^|^| |^| |^|^|
^|^| | | |^|^| | |^|^|^|^| | | |^|^|^|^| | |^|
^|^|^| |^|^| | | | | |^|^| |^| | | |^|^|^| |^|
^|^|^|^|^|^|^|^|^| | |^|^| |^| |^| |^| |^| |^|
^|^|^|^|^|^|^|^|^| |^|^| | |^| |^| |^|^|^| |^|
^| | |^| | | | | | | |^| |^|^| |^| |^| |^| |^|
^|^| | | |^| |^|^| | |^|^|^| | |^| |^|^|^| |^|
^|^| |^| |^| |^|^|^| | | | | |^|^| | | | | |^|
^|^|^|^|^|^|^|^|^|^|^|^|^|^|^|^|^|^|^|^|^|^|^|
