#    ^               _^
^^^^ ^ ^^^^^^^^^^^^^^^^
^^^^ ^ ^^^^^^^^^^^^^^^^
^^^^ ^ ^^^^^^^^^^^^^^^^
^^^^ ^ ^^^^^^^^^^^^^^^^
^^^^ ^ ^^^^^^^^^^^^^^^^
^^^^ ^ ^^^^^^^^^^^^^^^^
^^^^ ^ ^^^^^^^^^^^^^^^^
^^^^ ^ ^^^^^^^^^^^^^^^^
^^^^ ^ ^^^^^^^^^^^^^^^^
^^^^ ^ ^^^^^^^^^^^^^^^^
^^^^ ^ ^^^^^^^^^^^^^^^^
^^^^ ^ ^^^^^^^^^^^^^^^^
^^^^ ^ ^^^^^^^^^^^^^^^^
^^^^ ^ ^^^^^^^^^^^^^^^^
^^^^ ^ ^^^^^^^^^^^^^^^^
^^^^ ^ ^^^^^^^^^^^^^^^^
^^^^ ^ ^^^^^^^^^^^^^^^^
^^^^   ^^^^^^^^^^^^^^^^
^^^^^^^^^^^^^^^^^^^^^^