#| | | | |^| | | | | | | | | | | | | | | |_|^|
^|^|^|^| |^| |^|^|^|^|^|^|^|^|^|^|^|^|^|^|^|^|
^|^|^|^| |^| |^|^|^|^|^|^|^|^|^|^|^|^|^|^|^|^|
^|^|^|^| |^| |^|^|^|^|^|^|^|^|^|^|^|^|^|^|^|^|
^|^|^|^| |^| |^|^|^|^|^|^|^|^|^|^|^|^|^|^|^|^|
^|^|^|^| |^| |^|^|^|^|^|^|^|^|^|^|^|^|^|^|^|^|
^|^|^|^| |^| |^|^|^|^|^|^|^|^|^|^|^|^|^|^|^|^|
^|^|^|^| |^| |^|^|^|^|^|^|^|^|^|^|^|^|^|^|^|^|
^|^|^|^| |^| |^|^|^|^|^|^|^|^|^|^|^|^|^|^|^|^|
^|^|^|^| |^| |^|^|^|^|^|^|^|^|^|^|^|^|^|^|^|^|
^|^|^|^| |^| |^|^|^|^|^|^|^|^|^|^|^|^|^|^|^|^|
^|^|^|^| |^| |^|^|^|^|^|^|^|^|^|^|^|^|^|^|^|^|
^|^|^|^| |^| |^|^|^|^|^|^|^|^|^|^|^|^|^|^|^|^|
^|^|^|^| |^| |^|^|^|^|^|^|^|^|^|^|^|^|^|^|^|^|
^|^|^|^| |^| |^|^|^|^|^|^|^|^|^|^|^|^|^|^|^|^|
^|^|^|^| |^| |^|^|^|^|^|^|^|^|^|^|^|^|^|^|^|^|
^|^|^|^| |^| |^|^|^|^|^|^|^|^|^|^|^|^|^|^|^|^|
^|^|^|^| |^| |^|^|^|^|^|^|^|^|^|^|^|^|^|^|^|^|
^|^|^|^| | | |^|^|^|^|^|^|^|^|^|^|^|^|^|^|^|^|
^|^|^|^|^|^|^|^|^|^|^|^|^|^|^|^|^|^|^|^|^|^|^|
