#                    ²^
^^^^^^^^^^^^^^^^^^^^^^^
^%               %^°^^^
^^^^^^^^^^^^^^^^^^^ ^^^
^^^^^^^^^^^^^^^^^^^ ^^^
^^^^^^^^^^^^^^^^^^^ ^^^
^^^^^^^^^^^^^^^^^^^ ^^^
^^^^^^^^^^^^^^^^^^^ ^^^
^^^^^^^^^^^^^^^^^^^°^^^
^^^^^^^^^^^^^^^^^^^^^^^
^^^^^^^^^^^^^^^^^^^^^^^
^^^^^^^^^^^^^^^^^^^^^^^
^^^^^^^^^^^^^^^^^^^^^^^
^^^^^^^^^^^^^^^^^^^^^^^
^^^^^^^^^^^^^^^^^^^^^^^
^^^^^^^^^^^^^^^^^^^^^^^
^^^^^^^^^^^^^^^^^^^^^^^
^^^^^^^^^^^^^^^^^^^^^^^
^^^^^^^^^^^^^^^^^^^^^^^
^^^^^^^^^^^^^^^^^^^^^^^