20111110100111111111111
01000001011010022111111
00110100010000112222211
10001111000111111111211
00010000011100111111211
11011110110001111112211
00011100001111111112111
01000110101100111112111
01101000100011111112111
11100111101111111112211
11101101001100111111211
10001001011001111111211
00110010000010032211211
10111011011010111222211
10000011000000211112211
12211111112111111111221
12111111112111111111121
12122222222222222222121
12222222222222222222221
11111111111111111111111