# ^^^^^^^^^^^^^^^^^^^^^
^                     ^
^                     ^
^                     ^
^                     ^
^                     ^
^    ^ ^              ^
^    ^^^              ^
^    ^ ^              ^
^                     ^
^                     ^
^                     ^
^                     ^
^                     ^
^                     ^
^                     ^
^                     ^
^                     ^
^                   ²^
^^^^^^^^^^^^^^^^^^^^^^^