a| | | | | | | | | | | | | | | | | | | | | | |^|
 | | | | | | | | | | | | | | | | | | | | | | |^|
 | | | | | | | | | | | | | | | | | | | | | | |^|
 | | | | | | | | | | | | | | | | | | | | | | |^|
 | | | | | | | | | | | | | | | | | | | | | | |^|
 | | | | | | | | | | | | | | | | | | | | | | |^|
 | | | | | | | | | | | | | | | | | | | | | | |^|
 | | | | | | | | | | | | |f| | | | | | | | | |^|
 | | | | | | | | | | | | | | | | | | | | | | |^|
 | | | | | | | | | | | | | | | | | | | | | | |^|
 | | | | | | | | | | | | | | | | | | | | | | |^|
 | | | | | | | | | | | | | | | | | | | | | | |^|
 | | | | | | | | | | | | | | | | | | | | | | |^|
 | | | | | | | | | | | | | | | | | | | | | | |^|
 | | | | | | | | | | | | | | | | | | | | | | |^|
 | | | | | | | | | | | | | | | | | | | | | | |^|
 | | | | | | | | | | | | | | | | | | | | |f| |^|
 | | | | | | | | | | | | | | | | | | | | | | |^|
 | | | | | | | | | | | | | | | | | | | | | | |^|
 | | | | | | | | | | | | | | | | | | | | | |o|^|
^|^|^|^|^|^|^|^|^|^|^|^|^|^|^|^|^|^|^|^|^|^|^|^|

© Created by Henry Letellier with the software Create_levels, dedicated to create levels for wolf escape.
The person who created this level:
username=Hanra
userDiscordTagAndID=Hanra#8087
DiscordCodeID=483933572986568745
userOtherSocialMedia=none
