#| | | | |^| | | |^| | | |^| | | |^| | | |_|^|
^|^|^|^| |^| |^| |^| |^| |^| |^| |^| |^|^|^|^|
^|^|^|^| |^| |^| |^| |^| |^| |^| |^| |^|^|^|^|
^|^|^|^| |^| |^| |^| |^| |^| |^| |^| |^|^|^|^|
^|^|^|^| |^| |^| |^| |^| |^| |^| |^| |^|^|^|^|
^|^|^|^| |^| |^| |^| |^| |^| |^| |^| |^|^|^|^|
^|^|^|^| |^| |^| |^| |^| |^| |^| |^| |^|^|^|^|
^|^|^|^| |^| |^| |^| |^| |^| |^| |^| |^|^|^|^|
^|^|^|^| |^| |^| |^| |^| |^| |^| |^| |^|^|^|^|
^|^|^|^| |^| |^| |^| |^| |^| |^| |^| |^|^|^|^|
^|^|^|^| |^| |^| |^| |^| |^| |^| |^| |^|^|^|^|
^|^|^|^| |^| |^| |^| |^| |^| |^| |^| |^|^|^|^|
^|^|^|^| |^| |^| |^| |^| |^| |^| |^| |^|^|^|^|
^|^|^|^| |^| |^| |^| |^| |^| |^| |^| |^|^|^|^|
^|^|^|^| |^| |^| |^| |^| |^| |^| |^| |^|^|^|^|
^|^|^|^| |^| |^| |^| |^| |^| |^| |^| |^|^|^|^|
^|^|^|^| |^| |^| |^| |^| |^| |^| |^| |^|^|^|^|
^|^|^|^| |^| |^| |^| |^| |^| |^| |^| |^|^|^|^|
^|^|^|^| | | |^| | | |^| | | |^| | | |^|^|^|^|
^|^|^|^|^|^|^|^|^|^|^|^|^|^|^|^|^|^|^|^|^|^|^|
