#| | | | | | | | | | | | | | | | | | | | | |10|^|
^|^|^|^|^|^|^|^|^|^|^|^|^|^|^|^|^|^|^|^|^|^|^|
^|%| | | | | | | | | | | | | | | |%|^|°|^|^|^|
^|^|^|^|^|^|^|^|^|^|^|^|^|^|^|^|^|^|^| |^|^|^|
^|^|^|^|^|^|^|^|^|^|^|^|^|^|^|^|^|^|^| |^|^|^|
^|^|^|^|^|^|^|^|^|^|^|^|^|^|^|^|^|^|^| |^|^|^|
^|^|^|^|^|^|^|^|^|^|^|^|^|^|^|^|^|^|^| |^|^|^|
^|^|^|^|^|^|^|^|^|^|^|^|^|^|^|^|^|^|^| |^|^|^|
^|^|^|^|^|^|^|^|^|^|^|^|^|^|^|^|^|^|^|°|^|^|^|
^|^|^|^|^|^|^|^|^|^|^|^|^|^|^|^|^|^|^|^|^|^|^|
^|^|^|^|^|^|^|^|^|^|^|^|^|^|^|^|^|^|^|^|^|^|^|
^|^|^|^|^|^|^|^|^|^|^|^|^|^|^|^|^|^|^|^|^|^|^|
^|^|^|^|^|^|^|^|^|^|^|^|^|^|^|^|^|^|^|^|^|^|^|
^|^|^|^|^|^|^|^|^|^|^|^|^|^|^|^|^|^|^|^|^|^|^|
^|^|^|^|^|^|^|^|^|^|^|^|^|^|^|^|^|^|^|^|^|^|^|
^|^|^|^|^|^|^|^|^|^|^|^|^|^|^|^|^|^|^|^|^|^|^|
^|^|^|^|^|^|^|^|^|^|^|^|^|^|^|^|^|^|^|^|^|^|^|
^|^|^|^|^|^|^|^|^|^|^|^|^|^|^|^|^|^|^|^|^|^|^|
^|^|^|^|^|^|^|^|^|^|^|^|^|^|^|^|^|^|^|^|^|^|^|
^|^|^|^|^|^|^|^|^|^|^|^|^|^|^|^|^|^|^|^|^|^|^|
