#    ^               _^
^^^^ ^ ^^^^^^^^^^^^^^^^
^^^^ ^ ^^^^^^^^^^^^^^^^
^^^^ ^ ^^^^^^^^^^^^^^^^
^^^^ ^ ^^^^^^^^^^^^^^^^
^^^^ ^ ^^^^^^^^^^^^^^^^
^^^^ ^ ^^^^^^^^^^^^^^^^
^^^^ ^ ^^^^^^^^^^^^^^^^
^^^^ ^ ^^^^^^^^^^^^^^^^
^^^^ ^ ^^^^^^^^^^^^^^^^
^^^^ ^ ^^^^^^^^^^^^^^^^
^^^^ ^ ^^^^^^^^^^^^^^^^
^^^^ ^ ^^^^^^^^^^^^^^^^
^^^^ ^ ^^^^^^^^^^^^^^^^
^^^^ ^ ^^^^^^^^^^^^^^^^
^^^^ ^ ^^^^^^^^^^^^^^^^
^^^^ ^ ^^^^^^^^^^^^^^^^
^^^^ ^ ^^^^^^^^^^^^^^^^
^^^^   ^^^^^^^^^^^^^^^^
^^^^^^^^^^^^^^^^^^^^^^^