# ^^^^^^^^^^^^^^^^^^^^^
^                     ^
^                     ^
^                     ^
^                     ^
^                     ^
^      ^^^^^^^        ^
^         ^           ^
^         ^           ^
^         ^           ^
^      ^^^^^^^        ^
^                     ^
^                     ^
^                     ^
^                     ^
^                     ^
^                     ^
^                     ^
^                   ²^
^^^^^^^^^^^^^^^^^^^^^^^