#   ^ ^ ^^^ ^^^       ^
 ^^   ^               ^
  ^ ^^  ^^ ^ ^        ^
 ^     ^^^ ^ ^        ^
  ^^^^ ^^ ^   ^       ^
^   ^^  ^ ^^^         ^
^ ^ ^^^^     ^^       ^
^ ^ ^    ^^^ ^        ^
   ^^ ^^ ^   ^        ^
^ ^^     ^ ^^^        ^
^   ^^^^ ^    ^       ^
^^^ ^    ^^^          ^
^   ^ ^^^^^^  ^       ^
^ ^^^ ^               ^
^     ^^^ ^^^^²^^^^^ ^^
^  ^^^^^^^^^^^^^^^^^  ^
^ ^^^^^^^^ ^^^^^^^^^^ ^
^ ^                 ^ ^
^                     ^
^^^^^^^^^^^^^^^^^^^^^^^