#| | | | | | | | | | | | | | | | | | | | | |10|^|
^|^|^|^|^|^|^|^|^|^|^|^|^|^|^|^|^|^|^|^|^|^|^|
^|^|^|^|^|^|^|^|^|^|^|^|^|^|^|°|^|^|^|^|^|^|^|
^|^|^|^|^|^|^|^|^|^|^|^|^|^|^| |^|^|^|^|^|^|^|
^|^|^|^|^|^|^|^|^|^|^|^|^|^|^| |^|^|^|^|^|^|^|
^|^|^|^|^|^|^|^|^|^|^|^|^|^|^| |^|^|^|^|^|^|^|
^|^|^|^|^|^|^|^|^|^|^|^|^|^|^| |^|^|^|^|^|^|^|
^|^|^|^|^|^|^|^|^|^|^|^|^|^|^|°|^|^|^|^|^|^|^|
^|^|^|^|^|^|^|^|^|^|^|^|^|^|^|^|^|^|^|^|^|^|^|
^|^|^|^|^|^|^|^|^|^|^|^|^|^|^|^|^|^|^|^|^|^|^|
^|^|^|^|^|^|^|^|^|^|^|^|^|^|^|^|^|^|^|^|^|^|^|
^|^|^|^|^|^|^|^|^|^|^|^|^|^|^|^|^|^|^|^|^|^|^|
^|^|^|^|^|^|^|^|^|^|^|^|^|^|^|^|^|^|^|^|^|^|^|
^|^|^|^|^|^|^|^|^|^|^|^|^|^|^|^|^|^|^|^|^|^|^|
^|^|^|^|^|^|^|^|^|^|^|^|^|^|^|^|^|^|^|^|^|^|^|
^|^|^|^|^|^|^|^|^|^|^|^|^|^|^|^|^|^|^|^|^|^|^|
^|^|^|^|^|^|^|^|^|^|^|^|^|^|^|^|^|^|^|^|^|^|^|
^|^|^|^|^|^|^|^|^|^|^|^|^|^|^|^|^|^|^|^|^|^|^|
^|^|^|^|^|^|^|^|^|^|^|^|^|^|^|^|^|^|^|^|^|^|^|
^|^|^|^|^|^|^|^|^|^|^|^|^|^|^|^|^|^|^|^|^|^|^|
