♧000000000000000000000♤
♤♤♤♤♤♤♤♤♤♤♤♤♤♤♤♤♤♤♤♤♤♤♤
♤♤♤♤♤♤♤♤♤♤♤♤♤♤♤♤♤♤♤♤♤♤♤
♤♤♤♤♤♤♤♤♤♤♤♤♤♤♤♤♤♤♤♤♤♤♤
♤♤♤♤♤♤♤♤♤♤♤♤♤♤♤♤♤♤♤♤♤♤♤
♤♤♤♤♤♤♤♤♤♤♤♤♤♤♤♤♤♤♤♤♤♤♤
♤♤♤♤♤♤♤♤♤♤♤♤♤♤♤♤♤♤♤♤♤♤♤
♤♤♤♤♤♤♤♤♤♤♤♤♤♤♤♤♤♤♤♤♤♤♤
♤♤♤♤♤♤♤♤♤♤♤♤♤♤♤♤♤♤♤♤♤♤♤
♤♤♤♤♤♤♤♤♤♤♤♤♤♤♤♤♤♤♤♤♤♤♤
♤♤♤♤♤♤♤♤♤♤♤♤♤♤♤♤♤♤♤♤♤♤♤
♤♤♤♤♤♤♤♤♤♤♤♤♤♤♤♤♤♤♤♤♤♤♤
♤♤♤♤♤♤♤♤♤♤♤♤♤♤♤♤♤♤♤♤♤♤♤
♤♤♤♤♤♤♤♤♤♤♤♤♤♤♤♤♤♤♤♤♤♤♤
♤♤♤♤♤♤♤♤♤♤♤♤♤♤♤♤♤♤♤♤♤♤♤
♤♤♤♤♤♤♤♤♤♤♤♤♤♤♤♤♤♤♤♤♤♤♤
♤♤♤♤♤♤♤♤♤♤♤♤♤♤♤♤♤♤♤♤♤♤♤
♤♤♤♤♤♤♤♤♤♤♤♤♤♤♤♤♤♤♤♤♤♤♤
♤♤♤♤♤♤♤♤♤♤♤♤♤♤♤♤♤♤♤♤♤♤♤
♤♤♤♤♤♤♤♤♤♤д♤♤♤♤♤♤♤♤♤♤♤♤