# ^^^^^^^^^^^^^^^^^^^^^
^                     ^
^                     ^
^                     ^
^                     ^
^                     ^
^                     ^
^                     ^
^                     ^
^                     ^
^                     ^
^                     ^
^                     ^
^                     ^
^                     ^
^                     ^
^                     ^
^                     ^
^                   ²^
^^^^^^^^^^^^^^^^^^^^^^^