# ^^^^^^^^^^^^^^^^^^^^^
^                     ^
^                     ^
^                     ^
^                     ^
^                     ^
^                     ^
^      ^^    ^^       ^
^      ^ ^  ^ ^       ^
^      ^  ^^  ^       ^
^      ^      ^       ^
^                     ^
^                     ^
^                     ^
^                     ^
^                     ^
^                     ^
^                     ^
^                   ²^
^^^^^^^^^^^^^^^^^^^^^^^