# ^^^^^^^^^^^^^^^^^^^^^
^      ^ ^^ ^  ##^^^^^^
^ ^^ ^   ^    ^^#####^^
^   ^^^^   ^^^^^^^^^#^^
^  ^     ^^^  ^^^^^^#^^
^^ ^^^^ ^^   ^^^^^^##^^
^  ^^^    ^^^^^^^^^#^^^
^^   ^^ ^ ^^  ^^^^^#^^^
^^^ ^   ^   ^^^^^^^#^^^
^^^  ^^^^ ^^^^^^^^^##^^
^^^ ^^ ^  ^^  ^^^^^^#^^
^   ^  ^ ^^  ^^^^^^^#^^
^ ^^  ^     ^  ²##^^#^^
^ ^^^ ^^ ^^ ^ ^^^####^^
^     ^^      #^^^^##^^
^##^^^^^^^#^^^^^^^^^##^
^#^^^^^^^^#^^^^^^^^^^#^
^#^#################^#^
^#####################^
^^^^^^^^^^^^^^^^^^^^^^^